NO ./textures/north.xpm
SO ./textures/south.xpm
WE ./textures/west.xpm
EA ./textures/east.xpm
F 100,150,50
C 30,80,200

11111
10001
10N01
10001
11111
